##############
#            #
#            #
#     #      #
#     #      #
#            #
#            #
##############